"filename", "language", "HTML", "JavaScript", "CSS", "Java", "comment", "blank", "total"
"c:\Users\Shiro Goto\IDEA Projects\seisan\src\main\java\com\example\seisan\Const\Const.java", "Java", 0, 0, 0, 5, 10, 3, 18
"c:\Users\Shiro Goto\IDEA Projects\seisan\src\main\java\com\example\seisan\Controller\Form\FM10_EventForm.java", "Java", 0, 0, 0, 1, 2, 0, 3
"c:\Users\Shiro Goto\IDEA Projects\seisan\src\main\java\com\example\seisan\Controller\ST01_Controller.java", "Java", 0, 0, 0, 0, 0, 1, 1
"c:\Users\Shiro Goto\IDEA Projects\seisan\src\main\java\com\example\seisan\Repository\DB23_MemberRepository.java", "Java", 0, 0, 0, 1, 5, 1, 7
"c:\Users\Shiro Goto\IDEA Projects\seisan\src\main\java\com\example\seisan\Repository\Entity\ET10_Event.java", "Java", 0, 0, 0, 2, 1, 1, 4
"c:\Users\Shiro Goto\IDEA Projects\seisan\src\main\java\com\example\seisan\Service\Mapper\MP10_EventMapper.java", "Java", 0, 0, 0, 1, 2, 1, 4
"c:\Users\Shiro Goto\IDEA Projects\seisan\src\main\java\com\example\seisan\Service\Mapper\MP12_EventRelationMapper.java", "Java", 0, 0, 0, 7, 9, 3, 19
"c:\Users\Shiro Goto\IDEA Projects\seisan\src\main\java\com\example\seisan\Service\SV01_EventService.java", "Java", 0, 0, 0, -1, 45, 6, 50
"c:\Users\Shiro Goto\IDEA Projects\seisan\src\main\java\com\example\seisan\Service\SV01_EventServiceImpl.java", "Java", 0, 0, 0, 83, 49, 16, 148
"c:\Users\Shiro Goto\IDEA Projects\seisan\src\main\java\com\example\seisan\Service\SV02_MemberService.java", "Java", 0, 0, 0, 23, 95, 20, 138
"c:\Users\Shiro Goto\IDEA Projects\seisan\src\main\java\com\example\seisan\Service\SV02_MemberServiceImpl.java", "Java", 0, 0, 0, 143, 95, 24, 262
"c:\Users\Shiro Goto\IDEA Projects\seisan\src\main\java\com\example\seisan\Service\SV03_PaymentService.java", "Java", 0, 0, 0, 4, 15, 4, 23
"c:\Users\Shiro Goto\IDEA Projects\seisan\src\main\java\com\example\seisan\Service\SV03_PaymentServiceImpl.java", "Java", 0, 0, 0, 27, 15, 8, 50
"c:\Users\Shiro Goto\IDEA Projects\seisan\src\main\java\com\example\seisan\Service\SV04_PayerService.java", "Java", 0, 0, 0, -5, 0, -3, -8
"c:\Users\Shiro Goto\IDEA Projects\seisan\src\main\java\com\example\seisan\Service\SV05_PayeeService.java", "Java", 0, 0, 0, -5, 0, -3, -8
"c:\Users\Shiro Goto\IDEA Projects\seisan\src\main\resources\static\css\SC00V.css", "CSS", 0, 0, 3, 0, 0, 0, 3
"c:\Users\Shiro Goto\IDEA Projects\seisan\src\main\resources\static\css\SS01V.css", "CSS", 0, 0, 0, 0, 0, 1, 1
"c:\Users\Shiro Goto\IDEA Projects\seisan\src\main\resources\static\css\SS02V.css", "CSS", 0, 0, 0, 0, 0, 1, 1
"c:\Users\Shiro Goto\IDEA Projects\seisan\src\main\resources\static\css\SS03V.css", "CSS", 0, 0, 0, 0, 0, 1, 1
"c:\Users\Shiro Goto\IDEA Projects\seisan\src\main\resources\static\css\ST01V.css", "CSS", 0, 0, 0, 0, 0, 1, 1
"c:\Users\Shiro Goto\IDEA Projects\seisan\src\main\resources\static\css\ST02V.css", "CSS", 0, 0, 0, 0, 0, 1, 1
"c:\Users\Shiro Goto\IDEA Projects\seisan\src\main\resources\static\css\lib\bootstrap.min.css", "CSS", 0, 0, 2, 0, 4, 0, 6
"c:\Users\Shiro Goto\IDEA Projects\seisan\src\main\resources\static\js\SS01V.js", "JavaScript", 0, 0, 0, 0, 0, 1, 1
"c:\Users\Shiro Goto\IDEA Projects\seisan\src\main\resources\static\js\SS02V.js", "JavaScript", 0, 0, 0, 0, 0, 1, 1
"c:\Users\Shiro Goto\IDEA Projects\seisan\src\main\resources\static\js\SS03V.js", "JavaScript", 0, 0, 0, 0, 0, 1, 1
"c:\Users\Shiro Goto\IDEA Projects\seisan\src\main\resources\static\js\ST01V.js", "JavaScript", 0, 0, 0, 0, 0, 1, 1
"c:\Users\Shiro Goto\IDEA Projects\seisan\src\main\resources\static\js\ST02V.js", "JavaScript", 0, 0, 0, 0, 0, 1, 1
"c:\Users\Shiro Goto\IDEA Projects\seisan\src\main\resources\static\js\lib\bootstrap.min.js", "JavaScript", 0, 1, 0, 0, 6, 0, 7
"c:\Users\Shiro Goto\IDEA Projects\seisan\src\main\resources\static\js\lib\jquery-3.7.1.js", "JavaScript", 0, 6767, 0, 0, 1887, 2063, 10717
"c:\Users\Shiro Goto\IDEA Projects\seisan\src\main\resources\templates\SC00V_Common.html", "HTML", 24, 0, 0, 0, 19, 6, 49
"c:\Users\Shiro Goto\IDEA Projects\seisan\src\main\resources\templates\SM01V_EventRegist.html", "HTML", 9, 0, 0, 0, 0, 1, 10
"c:\Users\Shiro Goto\IDEA Projects\seisan\src\main\resources\templates\SM02V_EventEdit.html", "HTML", 9, 0, 0, 0, 0, 1, 10
"c:\Users\Shiro Goto\IDEA Projects\seisan\src\main\resources\templates\SM03V_PaymentRegist.html", "HTML", 9, 0, 0, 0, 0, 1, 10
"c:\Users\Shiro Goto\IDEA Projects\seisan\src\main\resources\templates\SM04V_PaymentEdit.html", "HTML", 9, 0, 0, 0, 0, 1, 10
"c:\Users\Shiro Goto\IDEA Projects\seisan\src\main\resources\templates\SM05V_EventTagRegist.html", "HTML", 9, 0, 0, 0, 0, 1, 10
"c:\Users\Shiro Goto\IDEA Projects\seisan\src\main\resources\templates\SM06V_EventTagEdit.html", "HTML", 9, 0, 0, 0, 0, 1, 10
"c:\Users\Shiro Goto\IDEA Projects\seisan\src\main\resources\templates\SM07V_GlobalMemberRegist.html", "HTML", 9, 0, 0, 0, 0, 1, 10
"c:\Users\Shiro Goto\IDEA Projects\seisan\src\main\resources\templates\SM08V_GlobalMemberEdit.html", "HTML", 9, 0, 0, 0, 0, 1, 10
"c:\Users\Shiro Goto\IDEA Projects\seisan\src\main\resources\templates\SM09V_GlobalMemberTagRegist.html", "HTML", 9, 0, 0, 0, 0, 1, 10
"c:\Users\Shiro Goto\IDEA Projects\seisan\src\main\resources\templates\SM10V_GlobalMemberTagEdit.html", "HTML", 9, 0, 0, 0, 0, 1, 10
"c:\Users\Shiro Goto\IDEA Projects\seisan\src\main\resources\templates\SS01V_EventTag.html", "HTML", 13, 0, 0, 0, 2, 1, 16
"c:\Users\Shiro Goto\IDEA Projects\seisan\src\main\resources\templates\SS02V_GlobalMember.html", "HTML", 13, 0, 0, 0, 2, 1, 16
"c:\Users\Shiro Goto\IDEA Projects\seisan\src\main\resources\templates\SS03V_GlobalMemberTag.html", "HTML", 13, 0, 0, 0, 2, 1, 16
"c:\Users\Shiro Goto\IDEA Projects\seisan\src\main\resources\templates\ST01V_Top.html", "HTML", 50, 0, 0, 0, 12, 2, 64
"c:\Users\Shiro Goto\IDEA Projects\seisan\src\main\resources\templates\ST02V_Seisan.html", "HTML", 13, 0, 0, 0, 2, 1, 16
"Total", "-", 216, 6768, 5, 286, 2279, 2177, 11731